   BBBB
GGGG  GGGG
GG GGGG GG
Z ZZZZZZ Z
ZZZZ  ZZZZ

 BB BB BB 
GGGG  GGGG
  GGGGGG  
ZZZZ  ZZZZ
  ZZZZZZ  

 B BBBB B 
GGG GG GGG
  GGGGGG  
  ZZZZZZ  
ZZZ ZZ ZZZ